NO ./textures/north_texture.xpm
SO ./textures/south_texture.xpm
WE ./textures/west_texture.xpm
EA ./textures/east_texture.xpm

C 200,200,200
F 100,100,100

1111111111111111111111111111111111111
1000000000000000000000000000000000001
1001000000000000000000000000000001001
1001000000000000000000011100100001001
1001000111000000000000010000100001001
1001000000000000000000010011100001001
1001000000000000000000010000100001001
1001000000111000000000011100100001001
1001000000000000000000010000100001001
1001000000000011100000010011100001001
1001000000000000000000010000100001001
1001000000000000000000011100100001001
1001000000000000000000010000100001001
1001000000000000000000010011100001001
1001000000000000000000010000000001001
1001000000000000000000011111111111001
1000000000000000011110000000000000001
1001000000000000011110000000000001001
1000000000000000011110000000000000001
1001000000000000011110000000000001001
1001000000000000000000000000000001001
1001000000000000000000000000000001001
1001000000000000000000000000000001001
1001000000000000000000000000000001001
1001000000000000000000000000000001001
1001000000000000000000000000000001001
1001000000000000000000000000000001001
1001000000000000000000000000000001001
1001000000000000000000000000000001001
1001000000000000000000000000000001001
1001000000000000000000000000000001001
1001000000000000000000000000000001001
1001000111100000000000001111010001001
1001000111100000000000001000010001001
1001000111100000000000001000010001001
1001000000000000000000001011110001001
1N01000000000000000000000000000000001
1111111111111111111111111111111111111
